Time 1 2 3 4 5 6 7 9 10 11 12 13 14 15 
1 11 20 20 20 20 20 20 20 20 19 17 15 13 11 
2 11 20 20 20 20 20 20 20 20 19 17 15 13 11 
3 1 10 10 10 10 10 10 10 10 9 7 5 3 1 
4 1 10 10 10 10 10 10 10 10 9 7 5 3 1 
5 1 10 10 10 10 10 10 10 10 9 7 5 3 1 
6 1 10 10 10 10 10 10 10 10 9 7 5 3 1 
7 1 10 10 10 10 10 10 10 10 9 7 5 3 1 
8 1 10 10 10 10 10 10 10 10 9 7 5 3 1 
9 1 10 10 10 10 10 10 10 10 9 7 5 3 1 
10 1 10 10 10 10 10 10 10 10 9 7 5 3 1 
11 1 10 10 10 10 10 10 10 10 9 7 5 3 1 
12 1 10 10 10 10 10 10 10 10 9 7 5 3 1 
13 1 10 10 10 10 10 10 10 10 9 7 5 3 1 
