Time 1 2 3 4 5 6 7 9 10 11 12 13 14 15 
1 11 20 20 14 11 20 11 11 11 11 11 11 11 11 
2 11 20 20 14 11 20 11 11 11 11 11 11 11 11 
3 11 20 20 14 11 20 11 11 11 11 11 11 11 11 
4 11 20 20 14 11 20 11 11 11 11 11 11 11 11 
5 11 20 20 14 11 20 11 11 11 11 11 11 11 11 
6 11 20 20 14 11 20 11 11 11 11 11 11 11 11 
7 11 20 20 14 11 20 11 11 11 11 11 11 11 11 
8 11 20 20 14 11 20 11 11 11 11 11 11 11 11 
9 11 20 20 14 11 20 11 11 11 11 11 11 11 11 
10 1 10 10 4 1 10 1 1 1 1 1 1 1 1 
11 1 10 10 4 1 10 1 1 1 1 1 1 1 1 
12 1 10 10 4 1 10 1 1 1 1 1 1 1 1 
13 1 10 10 4 1 10 1 1 1 1 1 1 1 1 
