Time 1 2 3 4 5 6 7 9 10 11 12 13 14 15 
1 11 20 20 20 20 20 20 20 20 20 20 20 20 20 
2 11 20 20 20 20 20 20 20 20 20 20 20 20 20 
3 11 20 20 20 20 20 20 20 20 20 20 20 20 20 
4 11 20 20 20 20 20 20 20 20 20 20 20 20 20 
5 11 20 20 20 20 20 20 20 20 20 20 20 20 20 
6 11 20 20 20 20 20 20 20 20 20 20 20 20 20 
7 11 20 20 20 20 20 20 20 20 20 20 20 20 20 
8 11 20 20 20 20 20 20 20 20 20 20 20 20 20 
9 11 20 20 20 20 20 20 20 20 20 20 20 20 20 
10 11 20 20 20 20 20 20 20 20 20 20 20 20 20 
11 1 10 10 10 10 10 10 10 10 10 10 10 10 10 
12 1 10 10 10 10 10 10 10 10 10 10 10 10 10 
13 1 10 10 10 10 10 10 10 10 10 10 10 10 10 
