Time 1 2 3 4 5 6 7 9 10 11 12 13 14 15 
1 11 20 20 20 20 20 20 19 17 15 13 11 11 11 
2 11 20 20 20 20 20 20 19 17 15 13 11 11 11 
3 11 20 20 20 20 20 20 19 17 15 13 11 11 11 
4 11 20 20 20 20 20 20 19 17 15 13 11 11 11 
5 11 20 20 20 20 20 20 19 17 15 13 11 11 11 
6 1 10 10 10 10 10 10 9 7 5 3 1 1 1 
7 1 10 10 10 10 10 10 9 7 5 3 1 1 1 
8 1 10 10 10 10 10 10 9 7 5 3 1 1 1 
9 1 10 10 10 10 10 10 9 7 5 3 1 1 1 
10 1 10 10 10 10 10 10 9 7 5 3 1 1 1 
11 1 10 10 10 10 10 10 9 7 5 3 1 1 1 
12 1 10 10 10 10 10 10 9 7 5 3 1 1 1 
13 1 10 10 10 10 10 10 9 7 5 3 1 1 1 
